..###################
....#.....#.........#
#.###.#####.#########
#...#.......#.......#
#.###.###.#####.###.#
#.....#.#.....#.#...#
#.###.#.#.#.###.###.#
#...#...#.#.#...#...#
#.###############.###
#.....#.#.#...#...#.#
#.###.#.#.###.###.#.#
#...#...#.#.....#...#
#.#.###.#.#.#######.#
#.#.#...#.#.....#...#
#.#######.#.#####.###
#.#.#.#.#...........#
#.#.#.#.#####.###.#.#
#.....#.#.....#...#.#
#.#.###.#.#.#.###.###
#.#.......#.#.#......
###################..
