#####################
#.#.....#.#.........#
#.###.###.#.#####.###
#...........#.#.#...#
#.###.#.###.#.#.#####
#.#...#...#.#.#.....#
###.#.#####.#.###.###
#.#.#.....#.........#
#.#.#.#.#########.###
#.#.#.#.........#...#
#.#.#########.#####.#
#...#.#.#.#.....#...#
#.###.#.#.#######.#.#
#.#...............#.#
#.#####.#####.#######
#.#.......#.....#...#
###.#########.#.###.#
#.....#.....#.#.#...#
#.#.#.#.###.#.###.#.#
#.#.#.#...#.......#.#
#####################
