..#############################
....#...#...#.....#.#...#.#...#
#.#####.#.#####.###.#.###.#.###
#.......#.#.....#...#...#.#...#
#.#.#.#.#.#####.#.#####.#.#.###
#.#.#.#...#.#...#.....#.#.#.#.#
#.###.###.#.###.#.#.###.#.#.#.#
#.#.#.#.........#.#.#.#.#.#...#
#.#.###.###.###.#.#.#.#.#.#.###
#...#...#.#.#.#...#...#.......#
###.#####.#.#.###.#.#######.#.#
#.#.......#...#.#.#.#.......#.#
#.#########.###.#.#.#.#####.###
#.........#.....#.#.#...#.....#
###.#.###.#.###.###########.###
#.#.#.#...#...#.....#.#.#...#.#
#.#####.#####.###.###.#.#.###.#
#.....#.#.#.....#.#.#...#.....#
#.###.#.#.###.#####.###.#####.#
#...#...#...#.....#.#.#...#...#
#.###.#.#.#.#.###.#.#.#.###.###
#...#.#.#.#.....#.#.......#...#
#.#####.#.###.###.#.#####.#.###
#.#.#...#.#...#.....#...#.#...#
#.#.#.#.###.###.#####.###.###.#
#.#...#.....#.........#.....#.#
#.#####.###.#.###.#######.###.#
#...#.....#.#...#.#.#.........#
#.###.#.#.#######.#.#.#.#.###.#
#...#.#.#...#.....#...#.#.#....
#############################..
