..#############################
........#...#.................#
#.###.#.#.#######.#.#.#####.#.#
#.#.#.#...#.#.#...#.#.#...#.#.#
#.#.###.#.#.#.#.#######.#.#.###
#.#.....#.....#...#.#...#.#...#
#######.###.###.#.#.###.#####.#
#...#.....#.....#.....#.......#
#.###.#########.#.#####.#####.#
#...#.#.....#.#.#...#...#...#.#
#.#.#.#.#####.###.#.###.#.###.#
#.#...#.#.......#.#.#.#...#...#
###.#.#.#.#.#######.#.#.###.###
#.#.#.....#.#.....#.#...#...#.#
#.#########.###.#.###.###.###.#
#.........#...#.#...#...#.#...#
#.#.#.#####.#######.#.#####.###
#.#.#.#.....#.................#
#.#.#.#####.#####.###.#.#.#.###
#.#.#.#...#.#.......#.#.#.#.#.#
#.#####.#####.###.###########.#
#.........#.....#...#.#.....#.#
#####.###.#####.#.###.#.#.#.#.#
#.#.....#.#.....#.#.#.#.#.#...#
#.#.#.#.#####.###.#.#.#.#.#####
#...#.#...#...#.#.......#.#...#
#.#######.#.###.#####.###.#.#.#
#.#.....#.#...#.........#...#.#
#.###.#.#.#.#######.#.###.#.###
#...#.#...........#.#...#.#....
#############################..
