..###################
........#.#.#.......#
#.#####.#.#.#######.#
#.....#.......#.#...#
###.#####.###.#.#.#.#
#.#.#.....#...#.#.#.#
#.#.#.#########.#.#.#
#...#.............#.#
#####.#.#.#####.#####
#.#...#.#...#...#...#
#.#.#.#.#####.#####.#
#...#.#.#.....#.....#
#.###########.#.###.#
#...#.......#...#...#
#.#.#####.#######.###
#.#...#...#.#.#...#.#
#.#####.#.#.#.###.#.#
#.#.....#...#...#...#
#.#.#.#####.#.#####.#
#...#...#...#........
###################..
