..###################
........#.#...#.....#
#.#####.#.#.###.#.#.#
#.....#...#.#...#.#.#
#.#######.#.###.#.###
#.....#.....#.#.#...#
#.#########.#.#####.#
#.....#...#.#.......#
###.###.###.#####.###
#...#.#.#.#.....#.#.#
#####.#.#.###.###.#.#
#.#.#.#.............#
#.#.#.#.#.###.###.###
#.....#.#...#.#.#...#
#####.#########.#.###
#.#.#.#.............#
#.#.#.#.###.#######.#
#.......#.#.....#...#
#.#.#.#.#.#.#.###.#.#
#.#.#.#...#.#.#...#.
###################.
