..###################
......#.........#.#.#
#.#.#####.#####.#.#.#
#.#.#.#...#.....#...#
#.###.###.#.#.###.###
#.......#.#.#...#...#
#.#######.#####.#.###
#.....#.......#.#.#.#
#.#######.#.#.#.#.#.#
#.......#.#.#.#.#.#.#
#.#.#########.#.#.#.#
#.#.#...#.....#...#.#
#.#####.#.###.###.#.#
#.....#.....#...#.#.#
#.#########.#.#####.#
#.........#.#...#.#.#
#####.###.#####.#.#.#
#.....#.#.......#...#
#.###.#.#.###.#.###.#
#.#...#.....#.#.....
###################.
