███████████████████████████████
█           █        █        █
████  ██████████  ████  ███████
█        █              █     █
█  █  █  ████  ████  ███████  █
█  █  █  █  █  █  █        █  █
█  ████  █  █  █  ████  ████  █
█     █  █           █  █     █
█  ██████████  █  ██████████  █
█     █     █  █           █  █
█  ████  ████  ████  █  ████  █
█  █  █     █     █  █        █
█  █  █  ███████  ████  ███████
█           █  █  █  █  █     █
█  ████  ████  █  █  █  █  ████
█     █     █        █  █     █
█  █  █  ███████  ████  █  █  █
█  █  █  █  █     █        █  █
█  █  █  █  █  █  █  █  █  ████
█  █  █        █  █  █  █     █
███████████████████████████████  
