..###########################################################
......#.............#.......#.#.#...#...#.#.................#
#.#.#.###.###########.###.#.#.#.#.#.#.#.#.#.#############.#.#
#.#.#...#.....#.#.#...#.#.#.#.....#.#.#...........#.#.#...#.#
#.#######.#####.#.#.###.###.###.###############.###.#.#.###.#
#.#.......#...........#...#.....#.........#...#...#.#...#...#
#.###.#######.###.#.###.#######.#.###.###.###.###.#.#######.#
#.......#.#.....#.#...#.#...#.....#.....#.#.......#.#...#...#
#.#.###.#.#.###.#######.###.###.###.#.#.#########.#.###.###.#
#.#.#.#.....#.#.....#.......#...#...#.#.#.#.......#...#.....#
###.#.#####.#.###.#########.#######.#####.###.#######.###.#.#
#.#.......#.#.........#.................................#.#.#
#.###.#.#.#####.#.###.#####.#.#####.#.###.#########.#.#.#####
#...#.#.#...#.#.#.#...#.....#.#.....#.#.#.....#.....#.#.....#
#.###.#.###.#.###########.#######.###.#.###.#########.#.#####
#.#.#.#.#.#.#...#.#.....#...#.......#.#.....#...#.#.#.#.....#
#.#.#.#.#.###.###.#.###.#######.###.#.###.#.#.#.#.#.#.#.#####
#.....#.#...#.........#...#.#.....#.#.#...#.#.#...#...#.....#
#.#####.###.#########.###.#.#.#.#############.#####.#.#######
#.....#.#...#.....#...#...#.#.#.#.........#.........#.....#.#
#.###.#####.#.###.#.###.#.#.#########.#######.###.#######.#.#
#...#.#.#...#...#...#.#.#.#.............#.......#.#.#.......#
#.###.#.###.#.#.###.#.#####.#.#####.#.###.#####.###.#######.#
#...#.#.....#.#...#.#...#...#.....#.#.....#.#.#.....#.#.#...#
#.###.###.#.#####.###.#.#######.###.###.###.#.###.###.#.#.###
#.#.#.#...#...#.....#.#...#.......#...#.#.....#.#.....#.....#
#.#.###.#.#.#.###.#.###.#.###.#######.#.#.###.#.#####.#####.#
#.....#.#.#.#...#.#...#.#.#.#...#...#.#.#.#...#...#.....#...#
#.#########.#.#######.#.###.###.#.#####.###.###.#####.#######
#...#.#...#.#...#.....#...#.#...#...#...#.........#.........#
#.#.#.#.#.###.#.###.#.#.###.###.#.#.#####.###.#.#.###.###.#.#
#.#...#.#.....#.....#.............#.#...#.#...#.#.#.....#.#.#
###.###.#######.###.###.#####.###.#.#.#.###.#####.#.###.###.#
#...#...#...#.#...#...#.#.#...#.#.#...#...#.#.....#...#...#.#
#######.#.###.###.#######.#####.#####.#####.###########.#.###
#.#.......#.......#...........#...#...#.....#.........#.#...#
#.###.#####.#####.#####.#.#.#.###.###.###.###.#####.###.#.###
#.#.....#.#.#...#...#.#.#.#.#.#.......#...........#.#...#.#.#
#.#.#####.#####.###.#.#####.#####.#.###.###.#####.#####.###.#
#.....#.......#...#...#...#.#.#...#.......#.#...#...#.#.....#
#.#.###.#######.#.#.#.#.###.#.###.#.#########.###.###.#.#.#.#
#.#.#.#...#.#.#.#...#.#.......#.#.#.#.#...#.........#.#.#.#.#
###.#.#.#.#.#.#####.#.#.#.###.#.#####.###.###.#.###.#.###.#.#
#.#.....#...#.#.....#.#.#.#...#.........#.....#...#...#...#.#
#.#.#########.#.#######.#.#####.#.#######.#####.###.#####.###
#.#.#.......#.......#...#.......#.#...#.#.#.#.#.#.....#.#...#
#.###.#.#######.#####.#######.#####.#.#.###.#.###.#####.#####
#.#...#...#.#...#.#.#.#...#.......#.#...#...#...#.......#.#.#
#.###.#.#.#.#.#.#.#.###.#.#.#####.#.###.###.###.#.#.#.###.#.#
#...#.#.#.....#.#.....#.#...#...#.#.#...#.......#.#.#.#.#...#
###.#######.#######.#######.#.#.###.###.#.###.#####.#.#.#.#.#
#.#...#...#.......#...#.#.#...#.......#.....#.#...#.#.....#.#
#.#.#.###.#####.#.###.#.#.#####.#######.#########.###.#.###.#
#.#.#.#.....#...#.......#.#.......#...#.#.....#.#.#.#.#...#.#
#.#.###.#.###.#########.#.#.#####.#.#.###.#.###.#.#.#.#######
#.#.....#.#.#.#...#...#.....#.#...#.#.#.#.#...#.....#.#.....#
#.###.###.#.###.###.#####.###.###.###.#.#.#####.#.#.#####.###
#.......#.............#...#.#...#...#...#.....#.#.#...#.#...#
#.#.#.#####.###.#.#.#.###.#.#.###.#.#.#.#.#.###.#.###.#.#.###
#.#.#.#.......#.#.#.#...........#.#...#...#.....#.#..........
###########################################################..
